#################
#S###############
#   G## # ###   #
#  #  # #  #    #
#  ####  ###    #
#      #        #
# ###      ##   #
# #  ## ###  #  #
#  ##       #   #
#   ### # ##    #
#              E#
#################
